// [invalid character list (; separated)] [replacement]

á       a
é       e
ő;ö;ó   o
ü;ű;ú   u
í       i
Á       A
É       E
Ő;Ö;Ó   O
Ü;Ű;Ú   U
Í       I
„       "
”       "
–       -
